[
  [ 1 , 2 , 2 , 2 , 2 , 2 , 7 ,99 , 1 , 2 , 2 , 2 , 2 , 2 , 2 , 2 , 7 ,99 , 1 , 2 , 2 , 2 , 2 , 2 , 7],
  [ 3 ,97 ,97 ,97 ,97 ,97 , 6 ,99 , 3 ,98 ,98 ,98 ,98 ,98 ,98 ,98 , 6 ,99 , 3 ,97 ,97 ,97 ,97 ,97 , 6],
  [ 3 ,97 ,18 ,97 ,18 ,97 , 6 ,99 , 3 ,98 ,17 ,98 ,17 ,98 ,17 ,98 , 6 ,99 , 3 ,97 ,18 ,97 ,18 ,97 , 6],
  [ 3 ,97 ,97 ,97 ,97 ,97 , 6 ,99 , 3 ,98 ,98 ,98 ,98 ,98 ,98 ,98 , 6 ,99 , 3 ,97 ,97 ,97 ,97 ,97 , 6],
  [ 3 ,97 ,18 ,97 ,18 ,97 , 6 ,99 , 3 ,98 ,17 ,98 ,17 ,98 ,17 ,98 , 6 ,99 , 3 ,97 ,18 ,97 ,18 ,97 , 6],
  [ 3 ,97 ,97 ,97 ,97 ,97 , 6 ,99 , 3 ,98 ,98 ,98 ,98 ,98 ,98 ,98 , 6 ,99 , 3 ,97 ,97 ,97 ,97 ,97 , 6],
  [ 4 , 5 , 5 , 5 ,13 , 0 , 6 ,99 , 3 ,98 ,17 ,98 ,17 ,98 ,17 ,98 , 6 ,99 , 3 , 0 ,11 , 5 , 5 , 5 ,21],
  [99 ,99 ,99 ,99 , 3 , 0 , 6 ,99 , 3 ,98 ,98 ,98 ,98 ,98 ,98 ,98 , 6 ,99 , 3 , 0 , 6 ,99 ,99 ,99 ,99],
  [99 ,99 ,99 ,99 , 3 ,95 , 6 ,99 , 4 , 5 , 5 , 5 ,95 , 5 , 5 , 5 ,21 ,99 , 3 ,95 , 6 ,99 ,99 ,99 ,99],
  [99 ,99 ,99 ,99 , 3 ,95 ,10 , 2 , 2 , 2 , 2 , 2 ,95 , 2 , 2 , 2 , 2 , 2 ,12 ,95 , 6 ,99 ,99 ,99 ,99],
  [99 ,99 ,99 ,99 , 3 , 0 , 0 , 0 , 0 , 0 , 0 , 0 , 0 , 0 , 0 , 0 , 0 , 0 , 0 , 0 , 6 ,99 ,99 ,99 ,99],
  [99 ,99 ,99 ,99 , 4 , 5 , 5 , 5 , 5 , 5 , 5 , 5 ,95 , 5 , 5 , 5 , 5 , 5 , 5 , 5 ,21 ,99 ,99 ,99 ,99],
  [99 ,99 ,99 ,99 ,99 ,99 ,99 ,99 ,99 ,99 ,99 ,99 ,95 ,99 ,99 ,99 ,99 ,99 ,99 ,99 ,99 ,99 ,99 ,99 ,99],
  [99 ,99 ,99 ,99 ,99 , 1 , 2 , 2 , 2 , 2 , 2 , 2 ,95 , 2 , 2 , 2 , 2 , 2 , 2 , 7 ,99 ,99 ,99 ,99 ,99],
  [99 ,99 ,99 ,99 ,99 , 3 , 0 , 0 , 0 , 0 , 0 , 0 , 0 , 0 , 0 , 0 , 0 , 0 , 0 , 6 ,99 ,99 ,99 ,99 ,99],
  [99 ,99 ,99 ,99 ,99 , 3 , 0 , 9 , 9 , 0 , 9 , 9 , 0 , 9 , 9 , 0 , 9 , 9 , 0 , 6 ,99 ,99 ,99 ,99 ,99],
  [99 ,99 ,99 ,99 ,99 , 3 , 0 , 0 , 0 , 0 , 0 , 0 , 0 , 0 , 0 , 0 , 0 , 0 , 0 , 6 ,99 ,99 ,99 ,99 ,99],
  [99 ,99 ,99 ,99 ,99 , 3 , 0 ,11 , 5 , 5 , 5 , 5 , 5 , 5 , 5 , 5 , 5 ,13 , 0 , 6 ,99 ,99 ,99 ,99 ,99],
  [99 ,99 ,99 ,99 ,99 , 3 , 0 , 6 ,99 ,99 ,99 ,99 ,99 ,99 ,99 ,99 ,99 , 3 , 0 , 6 ,99 ,99 ,99 ,99 ,99],
  [99 ,99 ,99 ,99 ,99 , 3 , 0 , 6 ,99 ,99 ,99 ,99 ,99 ,99 ,99 ,99 ,99 , 3 , 0 , 6 ,99 ,99 ,99 ,99 ,99],
  [99 ,99 ,99 ,99 ,99 , 3 , 0 , 6 ,99 ,99 ,99 ,99 ,99 ,99 ,99 ,99 ,99 , 3 , 0 , 6 ,99 ,99 ,99 ,99 ,99],
  [99 ,99 ,99 ,99 ,99 , 3 , 0 , 6 ,99 ,99 ,99 ,99 ,99 ,99 ,99 ,99 ,99 , 3 , 0 , 6 ,99 ,99 ,99 ,99 ,99],
  [ 1 , 2 , 2 , 2 , 2 ,12 , 0 ,10 , 2 , 2 , 2 , 2 , 2 , 2 , 2 , 2 , 2 ,12 , 0 ,10 , 2 , 2 , 2 , 2 , 7],
  [ 3 , 0 , 0 , 0 , 0 , 0 , 0 , 0 , 0 , 0 , 0 , 0 , 0 , 0 , 0 , 0 , 0 , 0 , 0 , 0 , 0 , 0 , 0 , 0 , 6],
  [ 3 , 0 , 9 , 0 ,11 , 5 , 5 , 5 ,13 , 0 ,16 , 0 ,16 , 0 ,16 , 0 ,11 , 5 , 5 , 5 ,13 , 0 , 9 , 0 , 6],
  [ 3 , 0 , 9 , 0 , 6 ,99 ,99 ,99 , 3 , 0 , 0 , 0 , 0 , 0 , 0 , 0 , 6 ,99 ,99 ,99 , 3 , 0 , 9 , 0 , 6],
  [ 3 , 0 , 0 , 0 , 6 ,99 ,99 ,99 , 3 ,16 , 0 ,16 , 0 ,16 , 0 ,16 , 6 ,99 ,99 ,99 , 3 , 0 , 0 , 0 , 6],
  [ 4 , 5 ,13 , 0 , 6 ,99 ,99 ,99 , 3 , 0 , 0 , 0 , 0 , 0 , 0 , 0 , 6 ,99 ,99 ,99 , 3 , 0 ,11 , 5 ,21],
  [99 ,99 , 3 , 0 ,10 , 2 , 2 , 2 ,12 , 0 ,11 , 5 , 5 , 5 ,13 , 0 ,10 , 2 , 2 , 2 ,12 , 0 , 6 ,99 ,99],
  [99 ,99 , 3 , 0 , 0 , 0 , 0 , 0 , 0 , 0 , 6 ,99 ,99 ,99 , 3 , 0 , 0 , 0 , 0 , 0 , 0 , 0 , 6 ,99 ,99],
  [99 ,99 , 3 , 0 , 9 , 0 , 9 , 0 , 9 , 0 , 6 ,99 ,99 ,99 , 3 , 0 , 9 , 0 , 9 , 0 , 9 , 0 , 6 ,99 ,99],
  [99 ,99 , 3 , 0 , 0 , 0 , 0 , 0 , 0 , 0 , 6 ,99 ,99 ,99 , 3 , 0 , 0 , 0 , 0 , 0 , 0 , 0 , 6 ,99 ,99],
  [99 ,99 , 3 , 0 ,11 , 5 , 5 , 5 ,13 , 0 ,10 , 2 , 2 , 2 ,12 , 0 ,11 , 5 , 5 , 5 ,13 , 0 , 6 ,99 ,99],
  [ 1 , 2 ,12 , 0 , 6 ,99 ,99 ,99 , 3 , 0 , 0 , 0 , 0 , 0 , 0 , 0 , 6 ,99 ,99 ,99 , 3 , 0 ,10 , 2 , 7],
  [ 3 , 0 , 0 , 0 , 6 ,99 ,99 ,99 , 3 ,16 , 0 ,16 , 0 ,16 , 0 ,16 , 6 ,99 ,99 ,99 , 3 , 0 , 0 , 0 , 6],
  [ 3 , 0 , 9 , 0 , 6 ,99 ,99 ,99 , 3 , 0 , 0 , 0 , 0 , 0 , 0 , 0 , 6 ,99 ,99 ,99 , 3 , 0 , 9 , 0 , 6],
  [ 3 , 0 , 9 , 0 ,10 , 2 , 2 , 2 ,12 , 0 ,16 , 0 ,16 , 0 ,16 , 0 ,10 , 2 , 2 , 2 ,12 , 0 , 9 , 0 , 6],
  [ 3 , 0 , 0 , 0 , 0 , 0 , 0 , 0 , 0 , 0 , 0 , 0 , 0 , 0 , 0 , 0 , 0 , 0 , 0 , 0 , 0 , 0 , 0 , 0 , 6],
  [ 4 , 5 , 5 , 5 , 5 ,13 , 0 ,11 , 5 , 5 , 5 , 5 , 5 , 5 , 5 , 5 , 5 ,13 , 0 ,11 , 5 , 5 , 5 , 5 ,21],
  [99 ,99 ,99 ,99 ,99 , 3 , 0 , 6 ,99 ,99 ,99 ,99 ,99 ,99 ,99 ,99 ,99 , 3 , 0 , 6 ,99 ,99 ,99 ,99 ,99],
  [99 ,99 ,99 ,99 ,99 , 3 , 0 , 6 ,99 ,99 ,99 ,99 ,99 ,99 ,99 ,99 ,99 , 3 , 0 , 6 ,99 ,99 ,99 ,99 ,99],
  [99 ,99 ,99 ,99 ,99 , 3 , 0 , 6 ,99 ,99 ,99 ,99 ,99 ,99 ,99 ,99 ,99 , 3 , 0 , 6 ,99 ,99 ,99 ,99 ,99],
  [99 ,99 ,99 ,99 ,99 , 3 , 0 , 6 ,99 ,99 ,99 ,99 ,99 ,99 ,99 ,99 ,99 , 3 , 0 , 6 ,99 ,99 ,99 ,99 ,99],
  [99 ,99 ,99 ,99 ,99 , 3 , 0 ,10 , 2 , 2 , 2 , 2 , 2 , 2 , 2 , 2 , 2 ,12 , 0 , 6 ,99 ,99 ,99 ,99 ,99],
  [99 ,99 ,99 ,99 ,99 , 3 , 0 , 0 , 0 , 0 , 0 , 0 , 0 , 0 , 0 , 0 , 0 , 0 , 0 , 6 ,99 ,99 ,99 ,99 ,99],
  [99 ,99 ,99 ,99 ,99 , 3 , 0 , 9 , 9 , 0 , 9 , 9 , 0 , 9 , 9 , 0 , 9 , 9 , 0 , 6 ,99 ,99 ,99 ,99 ,99],
  [99 ,99 ,99 ,99 ,99 , 3 , 0 , 0 , 0 , 0 , 0 , 0 , 0 , 0 , 0 , 0 , 0 , 0 , 0 , 6 ,99 ,99 ,99 ,99 ,99],
  [99 ,99 ,99 ,99 ,99 , 4 , 5 , 5 , 5 , 5 , 5 , 5 ,95 , 5 , 5 , 5 , 5 , 5 , 5 ,21 ,99 ,99 ,99 ,99 ,99],
  [99 ,99 ,99 ,99 ,99 ,99 ,99 ,99 ,99 ,99 ,99 ,99 ,95 ,99 ,99 ,99 ,99 ,99 ,99 ,99 ,99 ,99 ,99 ,99 ,99],
  [99 ,99 ,99 ,99 , 1 , 2 , 2 , 2 , 2 , 2 , 2 , 2 ,95 , 2 , 2 , 2 , 2 , 2 , 2 , 2 , 7 ,99 ,99 ,99 ,99],
  [99 ,99 ,99 ,99 , 3 , 0 , 0 , 0 , 0 , 0 , 0 , 0 , 0 , 0 , 0 , 0 , 0 , 0 , 0 , 0 , 6 ,99 ,99 ,99 ,99],
  [99 ,99 ,99 ,99 , 3 , 0 ,11 , 5 , 5 , 5 , 5 , 5 ,95 , 5 , 5 , 5 , 5 , 5 ,13 , 0 , 6 ,99 ,99 ,99 ,99],
  [99 ,99 ,99 ,99 , 3 ,95 , 6 ,99 , 1 , 2 , 2 , 2 ,95 , 2 , 2 , 2 , 7 ,99 , 3 ,95 , 6 ,99 ,99 ,99 ,99],
  [99 ,99 ,99 ,99 , 3 ,95 , 6 ,99 , 3 ,98 ,98 ,98 ,98 ,98 ,98 ,98 , 6 ,99 , 3 ,95 , 6 ,99 ,99 ,99 ,99],
  [ 1 , 2 , 2 , 2 ,12 , 0 , 6 ,99 , 3 ,98 ,17 ,98 ,17 ,98 ,17 ,98 , 6 ,99 , 3 , 0 ,10 , 2 , 2 , 2 , 7],
  [ 3 ,97 ,97 ,97 ,97 ,97 , 6 ,99 , 3 ,98 ,98 ,98 ,98 ,98 ,98 ,98 , 6 ,99 , 3 ,97 ,97 ,97 ,97 ,97 , 6],
  [ 3 ,97 ,18 ,97 ,18 ,97 , 6 ,99 , 3 ,98 ,17 ,98 ,17 ,98 ,17 ,98 , 6 ,99 , 3 ,97 ,18 ,97 ,18 ,97 , 6],
  [ 3 ,97 ,97 ,97 ,97 ,97 , 6 ,99 , 3 ,98 ,98 ,98 ,98 ,98 ,98 ,98 , 6 ,99 , 3 ,97 ,97 ,97 ,97 ,97 , 6],
  [ 3 ,97 ,18 ,97 ,18 ,97 , 6 ,99 , 3 ,98 ,17 ,98 ,17 ,98 ,17 ,98 , 6 ,99 , 3 ,97 ,18 ,97 ,18 ,97 , 6],
  [ 3 ,97 ,97 ,97 ,97 ,97 , 6 ,99 , 3 ,98 ,98 ,98 ,98 ,98 ,98 ,98 , 6 ,99 , 3 ,97 ,97 ,97 ,97 ,97 , 6],
  [ 4 , 5 , 5 , 5 , 5 , 5 ,21 ,99 , 4 , 5 , 5 ,15 , 0 ,19 , 5 , 5 ,21 ,99 , 4 , 5 , 5 , 5 , 5 , 5 ,21]
]
