[
  [99 ,99 ,99 , 1 , 2 , 2 , 2 , 2 , 7 ,99 ,99 ,99 ,99 ,99 ,99 , 1 , 2 , 2 , 2 , 2 , 7 ,99 ,99 ,99],
  [99 ,99 ,99 , 3 , 0 , 0 , 0 , 0 ,10 , 2 , 2 , 2 , 2 , 2 , 2 ,12 , 0 , 0 , 0 , 0 , 6 ,99 ,99 ,99],
  [99 ,99 ,99 , 3 , 0 ,22 ,23 , 0 , 0 , 0 , 0 , 0 , 0 , 0 , 0 , 0 , 0 ,22 ,23 , 0 , 6 ,99 ,99 ,99],
  [99 ,99 ,99 , 3 , 0 ,24 ,25 , 0 , 8 , 0 ,11 ,18 ,18 ,13 , 0 , 8 , 0 ,24 ,25 , 0 , 6 ,99 ,99 ,99],
  [99 ,99 ,99 , 3 , 0 , 0 , 0 , 0 ,20 , 0 , 6 ,99 ,99 , 3 , 0 ,20 , 0 , 0 , 0 , 0 , 6 ,99 ,99 ,99],
  [99 ,99 , 1 ,12 , 0 , 8 , 8 , 0 ,21 , 0 ,10 ,27 ,27 ,12 , 0 ,21 , 0 , 8 , 8 , 0 ,10 , 7 ,99 ,99],
  [99 ,99 , 3 ,20 , 0 , 0 , 0 , 0 , 0 , 0 , 0 , 0 , 0 , 0 , 0 , 0 , 0 , 0 , 0 , 0 ,20 , 6 ,99 ,99],
  [99 ,99 , 3 ,21 , 0 ,22 ,23 , 0 ,11 ,15 ,16 ,16 ,16 ,16 ,17 ,13 , 0 ,22 ,23 , 0 ,21 , 6 ,99 ,99],
  [99 ,99 , 4 ,13 , 0 ,24 ,25 , 0 , 6 , 0 ,11 ,15 ,17 ,13 ,26 , 3 , 0 ,24 ,25 , 0 ,11 ,29 ,99 ,99],
  [99 ,99 ,99 , 3 , 0 , 0 , 0 , 0 , 6 , 0 , 6 ,14 ,28 , 3 ,26 , 3 , 0 , 0 , 0 , 0 , 6 ,99 ,99 ,99],
  [99 ,99 ,99 , 3 , 0 ,22 ,23 , 0 , 6 , 0 ,10 ,95 ,95 ,12 ,26 , 3 , 0 ,22 ,23 , 0 , 6 ,99 ,99 ,99],
  [99 ,99 , 1 ,12 , 0 ,24 ,25 , 0 , 6 ,14 , 0 , 0 , 0 , 0 ,28 , 3 , 0 ,24 ,25 , 0 ,10 , 7 ,99 ,99],
  [99 ,99 , 3 ,20 , 0 , 8 , 8 , 0 ,10 , 2 , 2 , 2 , 2 , 2 , 2 ,12 , 0 , 8 , 8 , 0 ,20 , 6 ,99 ,99],
  [99 ,99 , 3 ,21 , 0 , 0 , 0 , 0 , 0 , 0 , 0 , 0 , 0 , 0 , 0 , 0 , 0 , 0 , 0 , 0 ,21 , 6 ,99 ,99],
  [99 ,99 , 4 , 5 ,13 , 0 ,11 , 5 , 5 , 5 , 5 , 5 , 5 , 5 , 5 , 5 , 5 ,13 , 0 ,11 , 5 ,29 ,99 ,99],
  [99 ,99 ,99 ,99 , 3 ,95 , 6 ,99 ,99 ,99 ,99 ,99 ,99 ,99 ,99 ,99 ,99 , 3 ,95 , 6 ,99 ,99 ,99 ,99],
  [99 ,99 ,99 ,99 , 3 ,95 , 6 ,99 ,99 ,99 ,99 ,99 ,99 ,99 ,99 ,99 ,99 , 3 ,95 , 6 ,99 ,99 ,99 ,99],
  [99 ,99 , 1 , 2 ,12 , 0 ,10 , 2 , 2 , 2 , 2 , 2 , 2 , 2 , 2 , 2 , 2 ,12 , 0 ,10 , 2 , 7 ,99 ,99],
  [99 ,99 , 3 , 0 , 0 , 0 , 0 , 0 , 0 , 0 , 0 , 0 , 0 , 0 , 0 , 0 , 0 , 0 , 0 , 0 , 0 , 6 ,99 ,99],
  [99 ,99 , 3 , 0 ,22 ,23 , 0 ,20 , 0 ,20 , 0 ,22 ,23 , 0 ,20 , 0 ,20 , 0 ,22 ,23 , 0 , 6 ,99 ,99],
  [99 ,99 , 3 , 0 ,24 ,25 , 0 ,21 , 0 ,21 , 0 ,24 ,25 , 0 ,21 , 0 ,21 , 0 ,24 ,25 , 0 , 6 ,99 ,99],
  [99 ,99 , 3 , 0 , 0 , 0 , 0 , 0 , 0 , 0 , 0 , 0 , 0 , 0 , 0 , 0 , 0 , 0 , 0 , 0 , 0 , 6 ,99 ,99],
  [99 ,99 , 4 , 5 ,13 , 0 ,11 , 5 , 5 , 5 , 5 , 5 , 5 , 5 , 5 , 5 , 5 ,13 , 0 ,11 , 5 ,29 ,99 ,99],
  [99 ,99 ,99 ,99 , 3 ,95 , 6 ,99 ,99 ,99 ,99 ,99 ,99 ,99 ,99 ,99 ,99 , 3 ,95 , 6 ,99 ,99 ,99 ,99],
  [99 ,99 ,99 ,99 , 3 ,95 , 6 ,99 ,99 ,99 ,99 ,99 ,99 ,99 ,99 ,99 ,99 , 3 ,95 , 6 ,99 ,99 ,99 ,99],
  [99 ,99 , 1 , 2 ,12 , 0 ,10 , 2 , 2 , 2 , 2 , 2 , 2 , 2 , 2 , 2 , 2 ,12 , 0 ,10 , 2 , 7 ,99 ,99],
  [99 ,99 , 3 , 0 , 0 , 0 , 0 , 0 , 0 , 0 , 0 , 0 , 0 , 0 , 0 , 0 , 0 , 0 , 0 , 0 , 0 , 6 ,99 ,99],
  [99 ,99 , 3 , 0 ,20 , 0 ,22 ,23 , 0 ,20 , 0 ,22 ,23 , 0 ,20 , 0 ,22 ,23 , 0 ,20 , 0 , 6 ,99 ,99],
  [99 ,99 , 3 , 0 ,21 , 0 ,24 ,25 , 0 ,21 , 0 ,24 ,25 , 0 ,21 , 0 ,24 ,25 , 0 ,21 , 0 , 6 ,99 ,99],
  [99 ,99 , 3 , 0 , 0 , 0 , 0 , 0 , 0 , 0 , 0 , 0 , 0 , 0 , 0 , 0 , 0 , 0 , 0 , 0 , 0 , 6 ,99 ,99],
  [99 ,99 , 4 , 5 , 5 , 5 , 5 , 5 , 5 , 5 ,30 , 0 ,31 , 5 , 5 , 5 , 5 , 5 , 5 , 5 , 5 ,29 ,99 ,99]
]
