[
  [ 1 , 2 , 2 , 2 , 2 , 2 , 2 , 2 , 2 , 2 , 2 , 2 , 7 ,99 ,99 , 1 , 2 , 2 , 2 , 7 ,99 ,99 ,99 ,99 , 1 , 2 , 2 , 7 ,99 ,99 ,99 ,99 ,99 ,99 ,99 ,99 ,99],
  [ 3 , 0 , 0 , 0 , 0 , 0 , 0 , 0 , 0 , 0 , 0 , 0 , 6 ,99 ,99 , 3 , 8 , 9 , 8 , 6 ,99 ,99 ,99 ,99 , 3 , 8 , 8 , 6 ,99 ,99 ,99 ,99 ,99 ,99 ,99 ,99 ,99],
  [ 3 , 0 , 9 , 9 , 0 , 9 , 0 , 9 , 0 , 9 , 9 , 0 , 6 ,99 ,99 , 3 , 9 , 0 , 0 , 6 ,99 ,99 ,99 ,99 , 3 , 0 , 0 , 6 ,99 ,99 ,99 ,99 ,99 ,99 ,99 ,99 ,99],
  [ 3 , 0 , 0 , 0 , 0 , 0 , 0 , 0 , 0 , 0 , 0 , 0 , 6 ,99 ,99 , 3 , 0 , 0 , 0 ,10 , 2 , 2 , 2 , 2 ,12 , 0 , 0 , 6 ,99 ,99 ,99 ,99 ,99 ,99 ,99 ,99 ,99],
  [ 3 , 0 , 9 , 0 ,11 , 5 , 5 , 5 ,13 , 0 , 9 , 0 ,10 , 2 , 2 ,12 , 0 , 9 , 0 , 0 , 0 , 0 , 0 , 0 , 0 , 0 , 0 , 6 ,99 ,99 , 1 , 2 , 2 , 2 , 2 , 2 , 7],
  [ 3 , 0 , 9 , 0 , 6 ,99 ,99 ,99 , 3 , 0 , 9 , 0 , 0 , 0 , 0 , 0 , 0 , 0 , 9 , 9 , 0 , 9 , 9 , 0 , 9 , 9 , 0 , 6 ,99 ,99 , 3 , 0 , 0 , 0 , 0 , 0 , 6],
  [ 3 , 0 , 0 , 0 , 6 ,99 ,99 ,99 , 3 , 0 , 0 , 0 ,11 , 5 , 5 ,13 , 0 , 0 , 9 , 0 , 0 , 0 , 0 , 0 , 0 , 9 , 0 ,10 , 2 , 2 ,12 , 0 , 9 , 0 , 9 , 0 , 6],
  [ 3 , 0 , 9 , 9 ,10 , 2 , 2 , 2 ,12 , 9 , 9 , 0 , 6 ,99 ,99 , 3 , 9 , 0 , 0 , 0 ,11 , 5 , 5 ,13 , 0 , 0 , 0 , 0 , 0 , 0 , 0 , 0 , 9 , 0 , 9 , 0 , 6],
  [ 3 , 0 , 0 , 0 , 0 , 0 , 0 , 0 , 0 , 8 , 0 , 0 , 6 ,99 ,99 , 3 , 9 , 0 , 9 , 0 , 6 ,99 ,99 , 3 , 0 , 9 , 0 ,11 , 5 , 5 ,13 , 0 , 0 , 0 , 0 , 0 , 6],
  [ 4 , 5 , 5 ,13 , 0 , 8 , 0 , 8 , 0 , 0 , 0 , 8 , 6 ,99 ,99 , 3 , 9 , 0 , 0 , 0 , 6 ,99 ,99 , 3 , 0 , 0 , 0 , 6 ,99 ,99 , 3 , 0 ,11 , 5 ,13 , 0 , 6],
  [99 ,99 ,99 , 3 , 0 , 8 , 0 , 0 , 0 ,11 , 5 , 5 ,15 ,99 ,99 , 3 , 0 , 0 , 9 , 0 , 6 ,99 ,99 , 3 , 0 , 9 , 0 , 6 ,99 ,99 , 3 , 0 , 6 ,99 , 3 , 0 , 6],
  [ 1 , 2 , 2 ,12 , 0 , 0 , 0 , 8 , 0 , 6 ,99 ,99 ,99 ,99 ,99 , 3 , 0 , 0 , 9 , 0 , 6 ,99 ,99 , 3 , 0 , 9 , 0 , 6 ,99 ,99 , 3 , 0 , 6 ,99 , 3 , 0 , 6],
  [ 3 , 8 , 0 , 0 , 0 , 8 , 0 , 8 , 0 ,10 , 2 , 2 , 7 ,99 ,99 , 3 , 9 , 0 , 0 , 0 , 6 ,99 ,99 , 3 , 0 , 0 , 0 , 6 ,99 ,99 , 3 , 0 ,10 , 2 ,12 , 0 , 6],
  [ 3 , 0 , 0 , 8 , 0 , 0 , 0 , 0 , 0 , 0 , 0 , 0 , 6 ,99 ,99 , 3 , 9 , 0 , 9 , 0 , 6 ,99 ,99 , 3 , 0 , 9 , 0 , 6 ,99 ,99 , 3 , 0 , 0 , 0 , 0 , 0 , 6],
  [ 3 , 0 , 9 , 9 ,11 , 5 , 5 , 5 ,13 , 9 , 9 , 0 , 6 ,99 ,99 , 3 , 9 , 0 , 0 , 0 ,10 , 2 , 2 ,12 , 0 , 0 , 0 , 6 ,99 ,99 , 3 , 0 , 9 , 0 , 9 , 0 , 6],
  [ 3 , 0 , 0 , 0 , 6 ,99 ,99 ,99 , 3 , 0 , 0 , 0 ,10 , 2 , 2 ,12 , 0 , 0 , 9 , 0 , 0 , 0 , 0 , 0 , 0 , 9 , 0 , 6 ,99 ,99 , 3 , 0 , 9 , 0 , 9 , 0 , 6],
  [ 3 , 0 , 9 , 0 , 6 ,99 ,99 ,99 , 3 , 0 , 9 , 0 , 0 , 0 , 0 , 0 , 0 , 0 , 9 , 9 , 0 , 9 , 9 , 0 , 9 , 9 , 0 , 6 ,99 ,99 , 3 , 0 , 0 , 0 , 0 , 0 , 6],
  [ 3 , 0 , 9 , 0 ,10 , 2 , 2 , 2 ,12 , 0 , 9 , 0 ,11 , 5 , 5 ,13 , 0 , 9 , 0 , 0 , 0 , 0 , 0 , 0 , 0 , 0 , 0 , 6 ,99 ,99 , 4 , 5 ,16 , 0 ,17 , 5 ,15],
  [ 3 , 0 , 0 , 0 , 0 , 0 , 0 , 0 , 0 , 0 , 0 , 0 , 6 ,99 ,99 , 3 , 0 , 0 , 0 ,11 , 5 , 5 , 5 , 5 ,13 , 0 , 0 , 6 ,99 ,99 ,99 ,99 ,99 ,99 ,99 ,99 ,99],
  [ 3 , 0 , 9 , 9 , 0 , 9 , 0 , 9 , 0 , 9 , 9 , 0 , 6 ,99 ,99 , 3 , 9 , 0 , 0 , 6 ,99 ,99 ,99 ,99 , 3 , 0 , 0 , 6 ,99 ,99 ,99 ,99 ,99 ,99 ,99 ,99 ,99],
  [ 3 , 0 , 0 , 0 , 0 , 0 , 0 , 0 , 0 , 0 , 0 , 0 , 6 ,99 ,99 , 3 , 8 , 9 , 8 , 6 ,99 ,99 ,99 ,99 , 3 , 8 , 8 , 6 ,99 ,99 ,99 ,99 ,99 ,99 ,99 ,99 ,99],
  [ 4 , 5 , 5 , 5 , 5 , 5 , 5 , 5 , 5 , 5 , 5 , 5 ,15 ,99 ,99 , 4 , 5 , 5 , 5 ,15 ,99 ,99 ,99 ,99 , 4 , 5 , 5 ,15 ,99 ,99 ,99 ,99 ,99 ,99 ,99 ,99 ,99]
]
