[
    [ 1 , 1 , 1 , 1 , 1 , 1 , 1 ,1 , 1 , 1 , 1 , 1 , 1 , 1 , 1 , 1 , 1 ,1 , 1 , 1 , 1 , 1 , 1 , 1 , 1 , 1 , 0 , 0 ,0 , 1],
    [ 1 , 0 ,124, 0 , 0 , 1 , 4 ,0 , 0 , 4 , 1 , 0 , 0 , 0 , 0 , 1 , 0 ,0 , 0 , 0 , 0 , 0 , 0 , 0 , 1 , 9 , 0 , 0 ,0 , 1],
    [ 1 , 0 , 0 , 0 , 0 , 0 , 0 ,0 , 0 , 4 , 1 , 0 , 0 , 0 , 0 , 1 , 0 ,0 , 0 , 0 , 0 , 0 , 0 , 0 , 1 , 9 , 0 , 0 ,0 , 1],
    [ 1 , 0 , 0 , 0 , 0 , 0 , 0 ,0 , 0 , 4 , 1 , 0 , 0 , 0 , 0 , 1 , 0 ,0 , 0 , 0 , 0 , 0 , 0 , 0 , 0 , 0 , 0 , 0 ,0 , 1],
    [ 1 ,123, 0 , 0 , 0 , 1 , 4 ,0 , 0 , 4 , 1 , 0 , 0 , 0 , 0 , 1 , 0 ,0 , 0 , 0 , 0 , 0 , 0 , 0 , 0 , 0 , 0 , 0 ,0 , 1],
    [ 1 , 1 , 1 , 1 , 1 , 1 , 4 ,0 , 0 , 4 , 1 , 0 , 0 , 0 , 0 , 1 , 0 ,0 , 0 , 0 , 0 , 0 , 0 , 0 , 1 , 9 , 0 , 0 ,0 , 1],
    [ 1 , 0 , 0 , 0 , 0 , 1 , 4 ,0 , 0 , 4 , 1 , 0 , 0 , 0 , 0 , 1 , 0 ,0 , 0 , 0 , 0 , 0 , 0 , 0 , 1 , 9 , 0 , 0 ,0 , 1],
    [ 1 , 0 , 0 , 0 , 0 , 1 , 4 ,0 , 0 , 4 , 1 , 0 , 0 , 0 , 0 , 1 , 0 ,0 , 0 , 0 , 0 , 0 , 0 , 0 , 1 , 9 , 0 , 0 ,0 , 1],
    [ 1 , 0 , 0 , 0 , 0 , 0 , 0 ,0 , 0 , 4 , 1 , 1 , 0 , 0 , 1 , 1 , 1 ,1 , 1 , 0 , 0 , 1 , 1 , 1 , 1 , 9 , 0 , 0 ,0 , 1],
    [ 1 , 0 , 0 , 0 , 0 , 0 , 0 ,0 , 0 , 4 , 4 , 4 , 0 , 0 , 4 , 4 , 4 ,4 , 4 , 0 , 0 , 4 , 4 , 4 , 1 , 9 , 0 , 0 ,0 , 1],
    [ 1 , 0 , 0 , 0 , 0 , 1 , 4 ,0 , 0 , 0 , 0 , 0 , 0 , 0 , 0 , 0 , 0 ,0 , 0 , 0 , 0 , 0 , 0 , 4 , 1 , 9 , 9 , 9 ,9 , 1],
    [ 1 , 0 , 0 , 0 , 0 , 1 , 4 ,0 , 0 , 0 , 0 , 0 , 0 , 0 , 0 , 0 , 0 ,0 , 0 , 0 , 0 , 0 , 0 , 4 , 1 , 7 , 7 , 7 ,7 , 1],
    [ 1 , 0 , 0 , 0 , 0 , 1 , 4 ,4 , 4 , 0 , 0 , 4 , 4 , 4 , 4 , 4 , 0 ,0 , 4 , 4 , 4 , 0 , 0 , 4 , 1 , 7 , 7 , 7 ,7 , 1],
    [ 1 , 1 , 1 , 1 , 1 , 1 , 1 ,1 , 1 , 0 , 0 , 1 , 1 , 1 , 1 , 1 , 0 ,0 , 1 , 1 , 4 , 0 , 0 , 4 , 1 , 7 , 7 , 7 ,7 , 1],
    [ 1 , 0 , 0 , 0 , 0 , 0 , 1 ,0 , 0 , 0 , 0 , 0 , 0 , 1 , 0 , 0 , 0 ,0 , 0 , 1 , 4 , 0 , 0 , 0 , 0 , 7 , 7 , 7 ,7 , 1],
    [ 1 , 0 , 0 , 0 , 0 , 0 , 0 ,0 , 0 , 0 , 0 , 0 , 0 , 1 , 0 , 0 , 0 ,0 , 0 , 1 , 4 , 0 , 0 , 0 , 0 , 7 , 7 , 7 ,7 , 1],
    [ 1 , 0 , 0 , 0 , 0 , 0 , 0 ,0 , 0 , 0 , 0 , 0 , 0 , 1 , 0 , 0 , 0 ,0 , 0 , 1 , 4 , 0 , 0 , 0 , 0 , 7 , 7 , 7 ,7 , 1],
    [ 1 , 125,0 , 0 , 0 , 0 , 0 ,0 , 0 , 0 , 0 , 0 , 0 , 1 , 0 , 0 , 0 ,0 , 0 , 1 , 4 , 0 , 0 , 4 , 1 , 7 , 7 , 7 ,7 , 1],
    [ 1 , 126,0 , 0 , 0 , 0 , 1 ,0 , 0 , 0 , 0 , 0 , 0 , 1 , 0 , 0 , 0 ,0 , 0 , 1 , 4 , 0 , 0 , 4 , 1 , 7 , 7 , 7 ,7 , 1],
    [ 1 , 1 , 1 , 1 , 1 , 1 , 1 ,1 , 1 , 1 , 1 , 1 , 1 , 1 , 1 , 1 , 1 ,1 , 1 , 1 , 1 , 0 , 0 , 1 , 1 , 1 , 1 , 1 ,1 , 1]
]
